25 25
100 100
2 2 2 2 2 2 2 2 2 2 2 2 2 2 2 2 2 2 2 2 2 2 2 2 2
2 1 0 0 0 0 0 0 0 0 0 0 0 0 0 0 0 0 1 0 0 0 0 0 2
2 1 0 2 2 2 2 1 1 1 0 0 0 0 0 0 0 0 1 0 0 0 0 0 2
2 1 0 0 0 0 0 0 0 0 0 0 0 0 0 0 0 0 1 0 0 0 0 0 2
2 1 0 0 0 0 0 0 0 0 0 0 0 0 0 0 0 0 1 0 0 0 0 0 2
2 1 0 0 0 0 0 0 0 0 0 0 0 0 0 0 0 0 1 0 0 0 0 0 2
2 1 0 0 1 1 1 1 1 1 0 0 0 0 0 0 0 0 1 0 0 0 0 0 2
2 1 0 0 0 0 0 0 0 0 0 0 0 0 0 0 0 0 1 3 0 0 0 0 2
2 1 0 4 3 4 4 4 4 4 4 0 0 0 0 0 0 0 1 3 0 0 0 0 2
2 1 0 4 3 3 3 3 3 3 4 0 0 0 0 0 0 0 1 3 0 0 0 0 2
2 1 0 4 4 4 4 4 4 3 4 0 0 0 0 0 0 0 1 3 0 0 0 0 2
2 1 0 0 0 0 0 0 4 3 4 0 0 0 0 0 0 0 1 3 0 0 0 0 2
2 1 0 0 0 0 0 0 4 3 4 0 0 0 0 0 0 0 1 3 0 0 0 0 2
2 1 0 0 0 0 0 0 4 3 4 0 0 0 0 0 0 0 1 3 0 0 0 0 2
2 1 0 0 0 0 0 0 4 3 4 0 0 0 0 0 0 0 1 3 0 0 0 0 2
2 1 0 0 0 0 0 0 0 0 0 0 0 0 0 0 0 0 1 3 0 0 0 0 2
2 1 0 0 0 0 0 0 0 0 0 0 0 0 0 0 0 0 1 2 0 0 0 0 2
2 1 0 0 0 0 0 0 0 0 0 0 0 0 0 0 0 0 1 2 0 0 0 0 2
2 1 0 0 0 0 0 0 0 0 0 0 0 0 0 0 0 0 1 2 0 0 0 0 2
2 0 0 0 0 0 0 0 0 0 0 0 0 0 0 0 0 0 0 0 0 0 0 0 2
2 0 0 0 0 0 0 0 0 0 0 0 0 0 0 0 0 0 0 0 0 0 0 0 2
2 0 0 0 0 0 0 0 0 0 0 0 0 0 0 0 0 0 0 0 0 0 0 0 2
2 0 0 0 0 0 0 0 0 0 0 0 0 0 0 0 0 0 0 0 0 0 0 0 2
2 0 0 0 0 0 0 0 0 0 0 0 0 0 0 0 0 0 0 0 0 0 0 0 2
2 2 2 2 2 2 2 2 2 2 2 2 2 2 2 2 2 2 2 2 2 2 2 2 2
