17 13
30 30
2 2 2 2 2 2 2 2 2 2 2 2 2 2 2 2 2
2 1 0 0 0 0 0 0 0 0 0 0 0 0 0 0 2
2 1 2 0 0 2 2 1 1 1 0 0 0 0 0 0 2
2 1 0 0 0 0 0 0 0 0 0 0 0 0 0 0 2
2 1 0 0 0 0 0 0 0 0 0 0 0 0 0 0 2
2 1 0 0 0 0 0 1 0 0 0 0 0 0 0 0 2
2 1 0 0 1 1 1 1 1 1 0 0 0 0 0 0 2
2 1 0 0 0 0 0 0 0 0 0 0 0 0 0 0 2
2 1 0 4 3 4 4 4 4 4 4 0 0 0 0 0 2
2 1 0 4 3 3 3 3 3 3 4 0 0 0 0 0 2
2 1 0 4 4 4 4 4 4 3 4 0 0 0 0 0 2
2 1 0 0 0 0 0 0 4 3 4 0 0 0 0 0 2
2 2 2 2 2 2 2 2 2 2 2 2 2 2 2 2 2

